-17
17
-12
14
00000000000000000000000000000000000
11000000000000000000000000000000110
11111111111111111111111111111111110
11111111111111111111111111111111110
11000000000000000000000000000000110
11000000000000000000000000000000110
11000000000000000000000000000000110
11000000000000000000000000000000110
11000011111100000000000000000000110
11000011111100000000000000000000110
11000011111100000000000000000000110
11000011111100000000000000000000110
11000011111100000000000000000000110
11000011111100000000000000000000110
11000000000000000000000111111000110
11000000000000000000000111111000110
11000000000000000000000111111000110
11000000000000000000000111111000110
11000000000000000000000111111000110
11000000000000000000000111111000110
11000000000000000000000000000000110
11000000000000000000000000000000110
11000000000000000000000000000000110
11000000000000000000000000000000110
11000000000000000000000000000000110
11111111111111111111111111111111110
11111111111111111111111111111111110
