-17
17
-12
14
11111111111111111111111111111111111
00111111111111111111111111111111001
00000000000000000000000000000000001
00000000000000000000000000000000001
00111111111111111111111111111111001
00111111111111111111111111111111001
00111111111111111111111111111111001
00111111111111111111111111111111001
00111100000011111111111111111111001
00111100000011111111111111111111001
00111100000011111111111111111111001
00111100000011111111111111111111001
00111100000011111111111111111111001
00111100000011111111111111111111001
00111111111111111111111000000111001
00111111111111111111111000000111001
00111111111111111111111000000111001
00111111111111111111111000000111001
00111111111111111111111000000111001
00111111111111111111111000000111001
00111111111111111111111111111111001
00111111111111111111111111111111001
00111111111111111111111111111111001
00111111111111111111111111111111001
00111111111111111111111111111111001
00000000000000000000000000000000001
00000000000000000000000000000000001
